...#..........
..............
......1.......
..............
..W...........
..............
.........W....
##############
