...#..........
..............
......1.......
..............
..............
..............
..............
##############
