.....................................................
.................X...................................
..........##########.................................
.....................................................
WWW....WWWW..........................................
---....####..........................................
.....................................................
WWW..................................................
###.........WWWWW....................................
............#####....................................
....WWW..............................................
....###..............................................
.....................................................
.1........W.W.W.W.W..................................
#####################################################